##############################
#S#·······················####
#·#··###############·#·#·····#
#·#··#############X#·#·#··#··#
#·#············#·#·#·#·#··#·##
#·#############·####·#·#··#··#
#·#########···#·#····#··##···#
#···········#········#·#·····#
#·######################··#··#
#·#·#··#······#······#····#··#
#·#·X··#··#······#···######··#
#·#·#··#······#··#······#····#
#·#·#####################····#
#·#·····#########············#
#·#················########··#
##############################